5.ox
.oo..o....o
.o.........
.o.o..i...o
......oo.o.
.oo..oo....
